%%%%%%%%%%
%.      .%
%        %
%        %
%        %
%        %
%        %
%      P %
%.      .%
%%%%%%%%%%